# # # # # # # # # # # # # # # # # # # # # # # # #
# S . . . . # . . . . . - . . . . . # . . . . . #
# . . . . . # . . . . . # . . . . . # . . . . . #
# . . . . . # . . . . . # . . . . . # . . . . . #
# . . . . . - . . . . . # . . . . . # . . . . . #
# . . . . . # . . . . . # . . . . . - . . . . . #
# - # # # # # . . . . . # # # # # - # . . . . . #
# . . . . . # # # # - # # . . . . . # # - # # # #
# . . . . . # . . . . . - . . . . . # . . . . . #
# . . . . . # . . . . . # . . . . . # . . . . . #
# . . . . . # . . . . . # . . . . . # . . . . . #
# . . . . . - . . . . . # . . . . . - . . . . G #
# # # # # # # # # # # # # # # # # # # # # # # # #