# # # # # # # # # # # # # #
# S . . # . . . . . . . . #
# . # . # . . . # . . . . #
# . # . . . . . # . . . . #
# . . . # # # # # # . # # #
# . # # # . . . # . . . . #
# . . . # . . . # # . # . #
# . . . . . . . # . . . . #
# # # # # # # . # . # # . #
# . . . # . . . # . . . . #
# . # . . . . . # . # # # #
# . # # # # # # # . . # G #
# . . . . . . . . . . . . #
# # # # # # # # # # # # # #