# # # # # # # # # # # # # # # # # # # # # # # # #
# S . . . . # . . . . . . . . . . . # . . . . . #
# . . . . . # . . . . . # . . . . . # . . . . . #
# . . . . . # . . . . . # . . . . . # . . . . . #
# . . . . . . . . . . . # . . . . . # . . . . . #
# . . . . . # . . . . . # . . . . . . . . . . . #
# . # # # # # . . . . . # # # # # . # . . . . . #
# . . . . . # # # # . # # . . . . . # # . # # # #
# . . . . . # . . . . . . . . . . . # . . . . . #
# . . . . . # . . . . . # . . . . . # . . . . . #
# . . . . . # . . . . . # . . . . . # . . . . . #
# . . . . . . . . . . . # . . . . . . . . . . G #
# # # # # # # # # # # # # # # # # # # # # # # # #