# # # # # # # # #
# S . . # . . . #
# . . . # . . . #
# . . . - . . . #
# . . . # # - # #
# - # # # . . . #
# . . . # . . . #
# . . . - . . G #
# # # # # # # # #